11 司机1
12 司机1
13 司机1
14 司机1
15 司机1
16 司机1
17 司机1
18 司机1
19 司机1
20 司机1
21 司机2
23 司机2
27 司机2
